ooo$  #oooo ##  o
ooo#  #o### #o  #
ooo#  #o  #   #o
$###   ## ### o#
       #      #o
#####       #   #
 oo##    #    #oo
 ## #       #####
             ###o
## ##         ##o
oo  #          #o
### #           $
    # #   #    #o
o# ## #   #   ##o
o# ## #####  ###o
#ooo# ooooo #####
